11111111111111111
10000000000000001
10111111111111101
10100000000000101
10101111111110101
10101000000000101
10101011111110101
10001000010000101
11111111011111101
10001010010000001
10010001010111101
10100100010000101
10010011111111101
10001001000000101
10000100111110101
10000010000010001
11111111111111111
